############
# .  .  .  #
#  * ## *  #
# .  ##  . #
# ##    ## #
# .  ..  . #
#  * .. *  #
# ##    ## #
# .  ##  . #
#  * ## *  #
# .  .  .  #
############