###############
# . . . . . . #
# ### ####### #
# # . . * . # #
# # ####### # #
# # . . . . # #
# # # ### # # #
# . # #.# # . #
# # # ### # # #
# # . . . . # #
# # ####### # #
# # . * . . # #
# ### ####### #
# . . . . . . #
###############