##############################
# . .    * . .    * . .      #
# ############**############ #
# . .        .  .   R    . . #
#   ##########  ##########   #
# . .    * .  .    * .       #
# . .        .  .        . . #
##############################