####################
# .  * .    .  *   #
# ######  ######## #
# # . .    . .   # #
# #  * #  * #      #
# # . . # . .    # #
# ######  ######## #
# .      .    R    #
# .  .  .  .  .  . #
####################