###############
# . .         #
# ### ####### #
# #     *   # #
# # ####### # #
#*#         # #
# # # ### # # #
#   # # #*#   #
# # # ### # # #
# #    *    # #
# # ####### # #
# #   *     # #
# ### ####### #
#             #
###############