####################
# .  * .    .  *   #
# ######  ######## #
# # . .    . .   # #
# #  * #  * #      #
# # . . # . .    # #
# ######  ######## #
# .      .         #
# .  .  .  .  .  . #
####################