  ############
  . .
# ### ####### #
      D *   #
# # ####### # #
#*#         # #
# # # ### # # #
#   # # #*#   #
# # # ### # # #
# #    *    # #
# # ####### # #
# #   *     # #
# ### ####### #

 ##############