########################################
#    . * .   .                         #
#   *    *  *             ##########   #
#  #   *                  #        #   #
#  #                      #        #   #
#  #    ###################        #   #
#  #                               #   #
#  #                               #   #
#  #                               #   #
#  #    ###################        #   #
#  #    #                 #        #   #
#  #    #                 #        #   #
#  ######                 ##########   #
#                                      #
########################################